                           D
0                          d 0
0                          210
0                            0
0    '   2111113     "       0
0  2113         213 213      0
0                        213 0
0                            0
0                            0
013                          0
0          '                 0
0  2113 211_113   "          0
0        00000  21113        0
0                      2113  0
0                            0
0  P                         0
0111113                     20
0                            0
0                   8 8      0
0          "   '             0
0_1_1_11111Y111T111_____111110