
0 D                          0
0 d                         '0
013                      8  20
0        13   211T113 8 8    0
0       10     00000         0
0   1_110   '                0
0   0110    8              8 0
0                      "     0
0                  8   1     0
0                      0     0
0 P       "        _   0 8   0
0111113   1113S211113  0     0
0         0   s        0     0
0         0  's  "     0     0
0         0   s  1     0  8  0
0     1YYY0   s  013   0     0
0  21100000   s  0    20     0
0             $  0           0
0                0       1   0
011111111111TT111011111110___0